2,1,1,1,1,1,1,1,0,0
0,7,8,9,8,5,0,1,0,0
0,8,3,3,1,3,0,1,0,0
0,5,0,0,0,3,0,1,0,0
0,0,1,3,3,3,0,1,0,0
4,0,0,0,0,0,0,1,0,0
6,0,1,3,3,3,3,1,0,0
0,0,0,0,0,0,0,0,0,0
0,0,1,0,1,0,1,0,0,0
0,0,0,0,0,0,0,0,0,0
